{
    "tiles": "objects.csv",
    "mapping": {
        "206": {"x": 224, "y": 96},
        "207": {"x": 240, "y": 96},
        "238": {"x": 224, "y": 112},
        "239": {"x": 240, "y": 112},
        "270": {"x": 224, "y": 128},
        "271": {"x": 240, "y": 128},

        "304": {"x": 256, "y": 144},
        "305": {"x": 272, "y": 144},
        "336": {"x": 256, "y": 160},
        "337": {"x": 272, "y": 160},
        "368": {"x": 256, "y": 176},
        "369": {"x": 272, "y": 176}
    }
}